11111111
1001110E
10100001
10001101
11000001
1P001001
11111111