11111111
1C0111E1
10100001
100C1101
11000001
1P0010C1
11111111